####################################################################################################################################################################################################################################################
#                                                                                                                                                                                                                                              \   #
#                                                                                                                                                                                                                                                  #
#                                                                                                                                                                                                                                                  #
#                                                                                                                                                                                                                                                  #
#                                                                                                                                                                                                                                                  #
#                                                                                                                                           +-+                                                                                                    #
#                                                                                                                                           <.|                                                                                                    #
#                                                                                                                                           <.|                                                                                                    #
#                                                                                                                                           +-+                                                                                                    #
#                                                                                                                                                   +-+                                                                                            #
#                                                                                                                                                   <.|                                                                                            #
#                                                                                                                           +------+                <.|                                                            +-+                             #
#                                                         +-+                                                               <......|                +-+                                                            <.|                             #
#                                                         <.|                                                               +------+-+    +-+                                                                      <.|                             #
#                              +----+                     <.|                                                                      |..^^^^..|                                                                      +-+                             #
#                              +vvvv+                     +-+                       +-----+                    +-------+           +--------+                                                                                                      #
#                                         +------+                                  +-----+                    <.......|                                                                             +-----+                                       #
#                                         |......|                                                       +-----+.......|                                          +-----+                            +-----+                                       #
#                                         +------+                        +-----+                        |.............|    +------+                              +-----+                                        +-----+                           #
#                            +-------+                +-------+           +-----+                   +----+.............|    |......>        +----------+                                  +-----+                |.....|                   +-------#
#                            |.......|                |.......>                                     <..................|    |......>        <..........|                     +-----+      +-----+                +-----+     +-+   +-+     |.......#
#     %              +-------+.......|                |.......+-------+                       +-----+..................|    |......>        <..........|                     +-----+                                         |..^^^..|     |.......#
#----------------+   |...............|                |...............|                       |........................|    |......+--------+..........|                                                                     |.......|     |.......#
#................|^^^|...............|^^^^^^^^^^^^^^^^|...............|^^^^^^^^^^^^^^^^^^^^^^^|........................|^^^^|..........................|^^^^^^^^^^^^^^^^^^^^^^^^^^^^^^^^^^^^^^^^^^^^^^^^^^^^^^^^^^^^^^^^^^^^^|.......|^^^^^|.......#
####################################################################################################################################################################################################################################################