####################################################################################################################################################################################################################################################
#                                                                                                                                                                                                                                                  #
#                                                                                                                                                                                                                                                  #
#                                                                                                                                                                                                                                                  #
#                                                                                                                                                                                                                                                  #
#                                                                                                                                                                                                                                                  #
#                                                                                                                                                                                                                                                  #
#                                                                                                                                                                                                                                                  #
#                                                                                                                                                                                                                                                  #
#                                                                                                                                                                                                                                                  #
#                                                                                                                                                                                                                                                  #
#                              +---+                                                                        -----                                                                                                                                  #
#                              +vvv+                                                                                                                                                                                                               #
#                                         +------+                                                                                                                                                                                                 #
#                                         |******|                                                   -----                                                  -----                                                                                  #
#                                         +------+                                                                                                                                                                                                 #
#                            +-------+                                                                                                                                                                                                             #
#                            |*******|                                                                                        -----                                                                                                                #
#                    +--^^^--+*******|                                                                                                                                                                                                             #
#    %               |***************|                                                                                                                                                                                                             #
#-----------------^^^+***************+^^^^^^^^^^^^----------------------------------------------------------------------------------------------------------------------------------------                                                      321#
####################################################################################################################################################################################################################################################