++++++++++++++++++++++++++++++++++++++++++++++++++++++++++++++++++++++++++++++++++++++++++++++++++++++++++++++++++++++++++++++++++++++++++++++++++++++++++++++++++++++++++++++++++++++++++++++++++++++++
+                                                                                                                                                                                                      +
+                                                                                                                                                                                                      +
+           ----------                                                                                                                                                                                 +
+ ----------                                                                                                                                                                                           +
+                                                                                                                                                                                                      +
+                                                                                                                                                                                                      +
+                                                                                                                                                                                                      +
+                                                                                                                                                                                                      +
+                                                                                                                                                                                                      +
+                                                                                                                                                                                                      +
+                                                                                                                                                                                                      +
+                                                                                                                                                                                                      +
+                                                                                                                                                                                                      +
+                                                                                                                                                                                                      +
+                                                                                                                                                                                                      +
+                                                                                                                                                                                                      +
+                                                                                                                                                                                                      +
+                        ----                                                                                                                                                                          +
+                             --                                                                                                                                                                       +
+                                 ----                                                                                                                                                                 +
+                             #           ---                                                                                                                                                          +
+                ----        ------------                                                                                                                                                              +
+          ----        ----                                                                                                                                                                            +
+    ----                                                                                                                                                                                              +
++++++++++++++++++++++++++++++++++++++++++++++++++++++++++++++++++++++++++++++++++++++++++++++++++++++++++++++++++++++++++++++++++++++++++++++++++++++++++++++++++++++++++++++++++++++++++++++++++++++++