####################################################################################################################################################################################################################################################
#                                                                                                                                                                                                                                                  #
#                                                                                                                                                                                                                                                  #
#                                                                                                                                                                                                                                                  #
#                                                                                                                                                                                                                                                  #
#                                                                                                                                                                                                                                                  #
#                                                                                                                                                                                                                                                  #
#                                                                                                                                                                                                                                                  #
#                                                                                                                                                                                                                                                  #
#                                                                                                                                                                                                                                                  #
#                                                                                                                                                                                                                                                  #
#                                                                                                                                                                                                                                                  #
#                                                                                                                                                                                                                                                  #
#                                                         +-+                                                                                                                                                                                      #
#                                                         <*|                                                                                                                                                                                      #
#                              +----+                     <*|                                                -----                                                                                                                                 #
#                              +vvvv+                     +-+                                                                                                                                                                                      #
#                                         +------+                                                                                                                                                                                                 #
#                                         |******|                                                   -----                                                  -----                                                                                  #
#                                         +------+                                                                                                                                                                                                 #
#                            +-------+                +-------+                                                                                                                                                                                    #
#                            |*******|                |*******|                                                               -----                                                                                                                #
#                    +-------+*******|                |*******+-------+                                                                                                                                                                            #
#    %               |***************|                |***************|                                                                                                                                                                            #
#-----------------^^^+***************+^^^^^^^^^^^^^^^^+***************+----------------------------------------------------------------------------------------------------------------------------------------------------------------------------#
####################################################################################################################################################################################################################################################