++++++++++++++++++++++++++++++++++++++++++++++++++++++++++++++++++++++++++++++++++++++++++++++++++++++++++++++++++++++++++++++++++++++++++++++++++++++++++++++++++++++++++++++++++++++++++++++++++++++++
+                                                                                                                                                                                                      +
+                                                                                                                                                                                                      +
+                                                                                                                                                                                                      +
+                                                                                                                                                                                                      +
+                                                                                                                                                                                                      +
+                                                                                                                                                                                                      +
+                                                                                                                                                                                                      +
+                                                                                                                                                                                                      +
+                                                                                                                                                                                                      +
+                                                                                                                                                                                                      +
+                                                                                                                                                                                                      +
+                                                                                                                                                                                                      +
+                                                                                                                                                                                                      +
+                                                                                                                                                                                                      +
+                                                                                                                                                                                                      +
+                                                                                                                                                                                                      +
+                                                                                                                                                                                                      +
+                                                                                                                                                                                                      +
+   #                                                                                                                                                                                                  +
+  ---------------------------------------------------------------------------------------------------------------------------------------------------------------------------------                   +
++++++++++++++++++++++++++++++++++++++++++++++++++++++++++++++++++++++++++++++++++++++++++++++++++++++++++++++++++++++++++++++++++++++++++++++++++++++++++++++++++++++++++++++++++++++++++++++++++++++++