+++++++++++++++++++++++++++++++
+                             +
+                             +
+    #      ----------        +
+ ----------                  +
+++++++++++++++++++++++++++++++