####################################################################################################################################################################################################################################################
#                                                                                                                                                                                                                                              \   #
#                                                                                                                                                                                                                                              \   #
#                                                                                                                                                                                                                                              \   #
#                                                                                                                                                                                                                                              \   #
#                                                                                                                                                                                                                                              \   #
#                                                                                                                                                                                                                                              \   #
#                                                                                                                                                                                                                                              \   #
#                                                                                                                                                                                                                                              \   #
#                                                                                                                                                                                                                                              \   #
#                                                                                                                                                                                                                                              \   #
#                                                                                                                                                                                                                                              \ F #
#                                                                                                                                                                                                                                              \ I #
#                                                         +-+                                                                                                                                                                                  \ N #
#                                                         <.|                                                                                                                                                                                  \   #
#                              +----+                     <.|                                                                                                                                                                                  \   #
#                              +vvvv+                     +-+                     +---+                       +-------+                                                                                                                        \   #
#                                         +------+                                +---+                       <.......|                                                                                                                        \   #
#                                         |......|                                                      +-----+.......|                                               -----                                                                    \   #
#                                         +------+                        +---+                         <.............|                                                                                                                        \   #
#                            +-------+                +-------+           +---+                    +----+.............|                                                                                                                        \   #
#                            |.......|                |.......|                                    <..................|                     -----                                                                                              \   #
#     %              +-------+.......|                |.......+-------+                      +-----+..................|                                                                                                                        \   #
#-----------------   |...............|                |...............|                      |........................|                                                                                                                        \   #
#                 ^^^+...............+^^^^^^^^^^^^^^^^+...............+^^^^^^^^^^^^^^^^^^^^^^+........................+------------------------------------------------------------------------------------------------------------------------\   #
####################################################################################################################################################################################################################################################