++++++++++++++++++++++++++++++++++++++++++++++++++++++++++++++++++++++++++++++++++++++++++++++++++++++++++++++++++++++++++++++++++++++++++++++++++++++++++++++++++++++++++++++++++++++++++++++++++++++++++++++++++++++++++++++++++++++++++++++++++++
+                                                                                                                                                                                                                                                  +
+                                                                                                                                                                                                                                                  +
+                                                                                                                                                                                                                                                  +
+                                                                                                                                                                                                                                                  +
+                                                                                                                                                                                                                                                  +
+                                                                                                                                                                                                                                                  +
+                                                                                                                                                                                                                                                  +
+                                                                                                                                                                                                                                                  +
+                                                                                                                                                                                                                                                  +
+                                                                                                      -----                                                                                                                                       +
+                                                                                                                                                                                                                                                  +
+                                                                                                                                                                                                                                                  +
+                                                                                                    -----                                                  -----                                                                                  +
+                                                                                                                                                                                                                                                  +
+                                                             -----                                                                                                                                                                                +
+                            -----                                                                                                                                                                                                                 +
+                                                                                                                             -----                                                                                                                +
+                                                                                                                                                                                                                                                  +
+   #                                                                                                                                                                                                                                              +
+  ------------------------------------     ----------------------------------------------------------------------------------------------------------------------------------------                                                               +
++++++++++++++++++++++++++++++++++++++++++++++++++++++++++++++++++++++++++++++++++++++++++++++++++++++++++++++++++++++++++++++++++++++++++++++++++++++++++++++++++++++++++++++++++++++++++++++++++++++++++++++++++++++++++++++++++++++++++++++++++++